g g g g g g g g g g g g g g g g g g g g g g g g g g g g g g g g g g g g W W G G 
G G G G G G G G G G G , , , , . G G G G G G G G G G G G G G G G G G G G G W W G
A A A A A A A A , , , A A A A . G G G G G G G G G G G G G G G G G G G G G W W W
A A A A A A A , A A A A A A A G . . . . . . . . . . . . . G G G G G G G G G W W 
A A A A A A A , A A A A A A A A A A A A A A A A A A A A , , , , , , , , , G G W 
A A A A A , , A A A A A A A A A A A A A A A A A A A A A A A A A A A A A A , , , 
A A A , , A A A A A A A A A A A A A A A A A A A A A A A A A A A A A A A A A A ,
A A , A A A A A A A A A A A A A A A A A A A A A A A A A A A A A A A A A A A A , 
, , A A A A A A A A A A A A A , , , 1 1 , , , , , , , 1 , A A A A A A A A A A , 
A A A A A A A A A A A A A A , A A A A A A A A A A A A A , A A A A A A A A A A ,
A A A A A A A A A A A A A , A A A A A A A A A A A A A A , A A A A A A A A A A ,
A A A A A A A A A A A A , A A A A A A A A A A A A A A , A A A A A A A A A A A ,
A A A A A A A A A A 1 , A A A A A A A A A A A A A A A , A A A A A A A A A A A , 
A A A A A A A A A 1 A A A A A A A A A A A A A A A A A , A A A A A A A A A A A ,
A A A A A A A A , A A A A A A A A A A A A A A A A A A , A A A A A A A A A A A ,
A A A A A A , , A A A A A A A A A A A A A A A A A A A , A A . . . . . A A A . A 
, , A A A , A A A A A A A A A A A A A A A A A A A A A , , , G G G G G . . . G g
G G . . . G G G G G G G G G G G G R R G G G G G G G G G G G G G G G G G G G G g 
G G G G G G G G G G G G G G G G G R R G G G G G G G G G G G G G G G G G G G G g 
G G G G G G G G G G G G G G G G R R R G G G G G G G G G G G G G G G G G G G G g 
G G G G G G G G G G G G G G G G R R G G G G G G G G G G G G G G G G G G G G G g 
G G G G G G G G G G G G G G G G R R G G G G G G G G G G G G G G G G G G G G G g 
G G G G G G G G G G G G G G G G R R G G G G G G G G G G G G G G G G G G G G G g 
G G G G G G G G G G G G G G G R R R G G G G G G G G G G G G G G G G G G G G G g 
G G G G G G G . G G G G G G G R R G G G G G G G G G G G G G G G G G G G G G G g 
G G G G G . . . . . G G G R R R R G G G G G G G G G G G G G G G G G G G G G G g 
G G G G G . G G G . G G G R R R G G G G G G G G G G G G G G W W W G G G G G G g 
G G G G G . G G G . G G G R R G G G G G G G G G G G G G G G G W W G G G G G G g  
G G G G G . . 2 . . G G G R R G G G G G G G G G G G G G G G G G G G G G G G G g 
G G G G G G G R R R R R R R R G G G G G G G G G G G G G G G G G G G G G G G G g 
G G G G G G G R R R R R R R R G G G G G G G G G G G G G G G G G G G G G G G G g 
G G G G G G G G G G G G G R R G G G G G G G G G G G G G G G G G G G G G G G G g 
G G G G G G G G G G G G G R R G G G G G G G G G G G G G G G G G G G G G G G G g 
G G G G G G G G G G G G G R R G G G G G G G G G G G G G G G G G G G G G G G G g 
G G G G G G G G G G G G G R R G G G G G G G G G G G G G G G G G G G G G G G G g 
G G G G G G G G G G G G G R R G G G G G G G G G G G G G G G G G G G G G G G G g 
G G G G G G G G G G G G G R R G G G G G G G G G G G G G G G G G G G G G G G G g 
G G G G G G G G G G G G G R R G G G G G G G G G G G G G G G G G G G G G G G G g 
g g g g g g g g g g g g g R g g g g g g g g g g g g g g g g g g g g g g g g g g 