g g g g g g g g g G G G G G G g g g g g g g g g g g g 
g g g g g g g g g G G G G G G g g g g g g g g g g g g 
g g g g g g g g g G G G G G G g g g g g g g g g g g g 
g g g g g g g g g G G G G G G g g g g g g g g g g g g 
g g g g g g g g g G G G G G G g g g g g g g g g g g g 
g g g g g g g g g G G G G G G g g g g g g g g g g g g 
g g g g g g g g g G G G G G G g g g g g g g g g g g g 
g g g g g g g g g G G G G G G g g g g g g g g g g g g 
g g g g g g g g g G G G G G G g g g g g g g g g g g g 
g g g g g g g g g G G G G G G g g g g g g g g g g g g 
g g g g g g g g g G G G G G G g g g g g g g g g g g g 
g g g g g g g g g G G G G G G g g g g g g g g g g g g 
g g g g g g g g g G G G G G G g g g g g g g g g g g g 
g g g g g g g g g G G G G G G g g g g g g g g g g g g 
g g g g g g g g g G G G G G G g g g g g g g g g g g g 
g g g g g g g g g G G G G G G g g g g g g g g g g g g 
g g g g g g g g g G G G G G G G G g g g g g g g g g g 
g g g g g g g g g G G G G G G G G G G G g g g g g g g 
g g g g g g g g g G G G G G G G G G G G G g g g g g g 
g g g g g g g g g G G G G G G G G G G G G G G g g g g 
g g g g g g g g g G G G G G G G G G G G G G G G G g g 
g g g g g g g g g G G G G G G G G G G G G G G G G G g 
g g g g g g g g g G G G G G G G G G G G . G . G G G G 
g g g g g g g g g G G G G G G G G G G G . . . G G G G 