, , , , , , , , , , , , , , , , , , , , , , , , , , , , , , , , , , , G G G G G G G G G G G G G G G G G G G G G G G R R R G G G G G G G G 
, G G G G G G G G G G G G G G G G G G G G G G G G G G G G G G G G G , G G G G G G G G G G G G G G G G G G G G G G G R R R G G G G G G G G 
, G G G G G G G G G G G G G G G G G G G G G G G G G G G G G G G G G , G G G G G G G G G G G G G G G G G G G G G G G R R R G G G G G G G G 
, G G G G G G G G G G G G G G G G G G G G G G G G G G G G G G G G G , G G G G G G G G G G G G G G G G G G G G G G G R R R G G G G G G G G
, G G G G G G G G G G G G G G G G G G G G G G G G G G G G G G G G G , G G G G G G G G G G G G G G G G G G G G G G G R R R G G G G G G G G
, G G G G G G G G G G G G G G G G G G G G G G G G G G G G G G G G G , G G G G G G G G G G G G G G G G G G G G G G G R R R G G G G G G G G
, G G G G G G G G G G G G G G G G G G G G G G G G G G G G G G G G G , G G G G G G G G G G G G G G G G G G G G G G G R R R G G G G G G G G 
, , , , , , , , , , , , , , , G , , , , , , , , , , , , , , , , , , , G G G G G G G G . G G G G . G G G G . G G G G R R R G G G G G G G G
A A A A A A A A A A A A A A A A A A A A A A A A A A A A A A A A A A A G G G G G . . . . . . . . . . . . . . . . G G R R R G G G G G G G G
A A A A A A A A A A A A A A A A A A A A A A A A A A A A A A A A A A A G G G G G . G G G G . G G G G . G G G G . G G R R R G G G G G G G G 
A A A A A A A A A A A A A A A A A A A A A A A A A A A A A A A A A A A G G G G G . G G G G . G G G G . G G G G . G G R R R G G G G G G G G
A A A A A A A A A A A A A A A A A A A A A A A A A A A A A A A A A A A G G G G G . . . 1 . . . . 1 . . . . 1 . . G G R R R G G G G G G G G 
R R R R R R R R R R R R R R R R R R R R R R R R R R R R R R R R R R R R R R R R R R R R R R R R R R R R R R R R R R R R R R R R R R R R R 
R R R R R R R R R R R R R R R R R R R R R R R R R R R R R R R R R R R R R R R R R R R R R R R R R R R R R R R R R R R R R R R R R R R R R
G G G . G G G G . G G G G G G G G G . G G G G . G G G G . G G G G R R G G G G G G G G G G G G G G G G G G G G G G G R R R G G G G G G G G
. . . . . . . . . . . . . . . . . . . . . . . . . . . . . . . G G R R G G G G G G G G G G G G G G G G G G G G G G G R R R G G G G G G G G
. G G G G . G G G G . G G G G . G G G G . G G G G . G G G G . G G R R G G G . G G G G . G G G G . G G G G . G G G G R R R G G G G G G G G
. G G G G . G G G G . G G G G . G G G G . G G G G . G G G G . G G R R . . . . . . . . . . . . . . . . . . . . . G G R R R G G G G G G G G
. . . 1 . . . . 1 . . . . 1 . . . . 1 . . . . 1 . . . . 1 . . G G R R . G G G G . G G G G . G G G G . G G G G . G G R R R G G G G G G G G
R R R R R R R R R R R R R R R R R R R R R R R R R R R R R R R R R R R . G G G G . G G G G . G G G G . G G G G . G G R R R G G G G G G G G
R R R R R R R R R R R R R R R R R R R R R R R R R R R R R R R R R R R . . . 1 . . . . 1 . . . . 1 . . . . 1 . . G G R R R G G G G G G G G
G G G G G G G G G G G G G G G G G G G G G G G G G G G G G G G G G R R R R R R R R R R R R R R R R R R R R R R R R R R R R G G G G G G G G 
G G G G G G G G G G G G G G G G G G G G G G G G G G G G G G G G G R R R R R R R R R R R R R R R R R R R R R R R R R R R R G G G G G G G G 
G G G G G G G G G G G G G G G G G G G G G G G G G G G G G G G G G G G G G G G G G G G G G G G G G G G G G G G G G G R R R G G G G G G G G
G G G G G G G G G G G G G G G G G G G G G G G G G G G G G G G G G G G G G G G G G G G G G G G G G G G G G G G G G G R R R G G G G G G G G
G G G G G G G G G G G G G G G G G G G G G G G G G G G G G G G G G G G G G G G G G G G G G G G G G G G G G G G G G G R R R G G G G G G G G 
G G G G G G G G G G G G G G G G G G G G G G G G G G G G G G G G G G G G G G G G G G G G G G G G G G G G G G G G G G R R R G G G G G G G G
G G G G G G G G G G G G G G G G G G G G G G G G G G G G G G G G G G G G G G G G G G G G G G G G G G G G G G G G G G R R R G G G G G G G G
. G . G G G G G G G G G G G G G G G G G G G G G G G G G G G G G G G G G G G G G G G G G G G G G G G G G G G G G G G R R R G G G G G G G G 