s s s s s s s s s s s s s s s s s s s s
s S S S S S S S S G G S S S S S S S S s
s S S S S S S S S S S S S S S S S S S s
s S S S S S S S S S S S S S S S S S S s
s S S S S S S S S S S S S S S S S S S s
s S S S S S S S S S S S S S S S S S S s
s S S S S S S S S S S S S S S S S S S s
s S S S S S S S S S S S S S S S S S S s
s S S S S S S S S S S S S S S S S S S s
s S S S S S S S S S S S S S S S S S S s
s S S S S S S S S S S S S S S S S S S s
s S S S S S S S S S S S S S S S S S S s
s S S S S S S S S S S S S S S S S S S s
s S S S S S S S S S S S S S S S S S S s
s s s s s s s s s G G s s s s s s s s s 