s s s s s s s s s s s s s s s s s s s s
s L L L L L L L L G G L L L L L L L L s
s L L L L L L L L L L L L L L L L L L s
s L L L L L L L L L L L L L L L L L L s
s L L L L L L L L L L L L L L L L L L s
s L L L L L L L L L L L L L L L L L L s
s L L L L L L L L L L L L L L L L L L s
s L L L L L L L L L L L L L L L L L L s
s L L L L L L L L L L L L L L L L L L s
s L L L L L L L L L L L L L L L L L L s
s L L L L L L L L L L L L L L L L L L s
s L L L L L L L L L L L L L L L L L L s
s L L L L L L L L L L L L L L L L L L s
s L L L L L L L L L L L L L L L L L L s
s s s s s s s s s G G s s s s s s s s s 