s s s s s s s s s s s s s s s s s s s s
s A A A A A A A A G G A A A A A A A A s
s A A A A A A A A A A A A A A A A A A s
s A A A A A A A A A A A A A A A A A A s
s A A A A A A A A A A A A A A A A A A s
s A A A A A A A A A A A A A A A A A A s
s A A A A A A A A A A A A A A A A A A s
s A A A A A A A A A A A A A A A A A A s
s A A A A A A A A A A A A A A A A A A s
s A A A A A A A A A A A A A A A A A A s
s A A A A A A A A A A A A A A A A A A s
s A A A A A A A A A A A A A A A A A A s
s A A A A A A A A A A A A A A A A A A s
s A A A A A A A A A A A A A A A A A A s
s s s s s s s s s G G s s s s s s s s s 