s s s s s s s s s s s s s s s s s s s s
s O O O O O O O O G G O O O O O O O O s
s O O O O O O O O O O O O O O O O O O s
s O O O O O O O O O O O O O O O O O O s
s O O O O O O O O O O O O O O O O O O s
s O O O O O O O O O O O O O O O O O O s
s O O O O O O O O O O O O O O O O O O s
s O O O O O O O O O O O O O O O O O O s
s O O O O O O O O O O O O O O O O O O s
s O O O O O O O O O O O O O O O O O O s
s O O O O O O O O O O O O O O O O O O s
s O O O O O O O O O O O O O O O O O O s
s O O O O O O O O O O O O O O O O O O s
s O O O O O O O O O O O O O O O O O O s
s s s s s s s s s G G s s s s s s s s s 