s s s s s s s s s s s s s s s s s s s s
s M M M M M M M M G G M M M M M M M M s
s M M M M M M M M M M M M M M M M M M s
s M M M M M M M M M M M M M M M M M M s
s M M M M M M M M M M M M M M M M M M s
s M M M M M M M M M M M M M M M M M M s
s M M M M M M M M M M M M M M M M M M s
s M M M M M M M M M M M M M M M M M M s
s M M M M M M M M M M M M M M M M M M s
s M M M M M M M M M M M M M M M M M M s
s M M M M M M M M M M M M M M M M M M s
s M M M M M M M M M M M M M M M M M M s
s M M M M M M M M M M M M M M M M M M s
s M M M M M M M M M M M M M M M M M M s
s s s s s s s s s G G s s s s s s s s s 