l l l l l l l l l l l l l l l l l l l l l l l l l l l l l l l l 
l L L L L L L L L L L L L l L L L L L L L L L L L L L L L L L l 
l L L L L L L L L L L L L l L L L L L L L L L L L L L L L L L l 
l L L L L L L L L L L L L l L L L L L L L L L L L L L L L L L l 
l L L L L L L L L L L L L l L L L L L L L L L L L L L L L L L l 
l L L L L L L L L L L L L l L L L L L L L L L L L L L L L L L l 
l L L L L L L L L L L L L l L L L L L L L L L L L L L L L L L l 
l L L L L L L L L L L L L l L L L L L L L L L L L L L L L L L l 
l l L l l l l l l l l l l l l l L l l l l l l l l l l l l l l l
F F L F F F F F F F F F F F F F L F F F F F F F F F F F F F F l 
L L L L L L L L L L L L L L L L L L L L L L L L L L L L L L L L 
L L L L L L L L L L L L L L L L L L L L L L L L L L L L L L L L 
L L L L L L L L L L L L L L L L L L L L L L L L L L L L L L L L 
L L L L L L L L L L L L L L L L L L L L L L L L L L L L L L L L 
F F F F F F F F F L L F F F F F F F F F F F F F F F F F F F F L 
l l l l l l l l l X X l l l l l l l l l l l l l l l l l l l l l 